.....0......
.....###....
..3..X..3...
..#..#..#...
X.X.X.X.X.X.
####.3333...
...XX..3....
...X...3....
...G...X.3..
.....3......
............

